8
8
########
#@$   .#
#   #  #
#   #  #
# .# $ #
# $    #
#     .#
########