9
9
#########
#@  #   #
# $ # $ #
#  . .  #
##  #  ##
#  . .  #
# $ # $ #
#   #   #
#########