11
5
###########
#@  ###   #
# $ #  $  #
#     .##.#
###########