8
8
########
#@$   .#
#      #
#      #
# .  $ #
# $    #
#     .#
########