22
11
    #####
    #   #
    #   #
  ###   ###
  #       #
### # ### #     ######
#   # ### #######    #
# $  $              .#
##### #### #@####   .#
    #      ###  ######
    ########