11
11
###########
#    @    #
# $ $ $ $ #
#  $ $ $  #
# # $ $ # #
# #  $  # #
# ## . ## #
# # . . # #
###. . .###
 #. . . .#
 #########